R 1920 11080



NO ./image_texture/test.xpm
SO ./image_texture/test1.xpm


WE ./image_texture/test1.xpm


hEA ./image_texture/test3.xpm
S ./image_sprite/test0.xpm

F 150,150,150


C 200,236,255

     1
 111101
1E0021
 11111
 
 11111
 111101
     1
       
  
  
  