R 1920 1080
NO ./texture/colored_stone_wall.xpm

SO ./texture/stone_wall.xpm

WE ./texture/colored_stone_wall.xpm

EA ./texture/gray_stone_wall.xpm

S ./path_to_the_sprite_texture
F 220,100,0
C 225,30,0

        1111111111111111111111111
        1000000000100000000000001
        1001001001110000001000101
        1001000000000000000000001
111111111011000001110000000000001
100000000011010001110111111111111
11110111111111000001000010001
11110111111110000000010010001
11000000110101000001000010001
10001000000001000111000000001
10000000000000001101010010001
110000011101010111110111100111
11110111 1110101 10111 1010001
111111 1111 111  111111 11111111
